#######E########E####################
# ### #   ###### #    #     #     # E
# ### ### #      # #     #     #    #
# ### # # # ###### ##################
#            #       #    #   #   # #
#  # ##      # ##### #  # # # # # # #
#  #         #   #   #  # # # # #   #
#  ######   ###  #  ### # # # # ### #
#  #    #               #   #   #   #
#  # ## ########   ## ###########   #
#    ##          ###                #
# ## #############  ###   ####   ## #
#  ### ##         #  #  #           #
#  #   ## ####     #    #      ###  #
#  # #### #  #     #    #####       #
#  #      #      ###           ##   #
#  #####           #   ##   #   #   #
#                                   #
##################^##################